10123
1112121112
1121121111
1211111122
1211122121
1121111111
1112211221
1211112112
2111121111
1211221112
1111211111